NO ./assets/textures/north.xpm
SO ./assets/textures/south.xpm
WE ./assets/textures/west.xpm
EA ./assets/textures/east.xpm

F 211,211,211
C 173, 216, 230

111111111111111111111111111111111
100000000000000000000000000000001
100000000000000000000000000000001
111111111100000000000111111111111
         1000000000001
         111111S111111
         1000000000001
111111111100000000000111111111111
100000000000000000000000000000001
100000000000000000000000000000001
111111111111111111111111111111111
